1111111111111111111
1P00000000C0F0000E1
1111111111111111111