1111111111111111111
1P00000000C0E0000C1
1111111111111111111